c w u w c c c c w c c w u
c c w c w c w c c w c c w
c w c c c w c w c w c w c
c c c w c c c c c c c c c
w c w c c w c w c w c w c
w c c w c w c w c c w c c
c w c w c w c w c w c w c
c w w c c c w c c c c w c
c c c c w c w c w c w c c
c w c w u w c c c w c c w
